abate = μειώνω = reduce/diminish/lessen
abdicate = παραιτούμαι = resign/quit/forsake/waive
abberant = παρεκκλίνων = deviant/abnormal
abhor = απεχθάνομαι = detest/abominate/loathe
abjure = αποκηρύσσω = renounce/repudiate/recant
abrasive = τραχύς = rude/rough/rugged
abridge = μειώνω = reduce/lessen/abate
abstain = απέχω = refrain/decline to vote
acme = ακμή = summit/peak/climax/zenith
adhere (to) = προσκολλούμαι σε = devote/cleave to sth/cling to sth
admonish = επιπλήτω/νουθετώ = scold/reprimand/rebuke/berate (sb)
adverse = δυσμενής = unfavorable/unpropitious
advocate = συνηγορώ = plead/defend
affable = καταδεκτικός = friendly/approachable/congenial
affectation = επιτήδευση/προσποίηση = pretension/meannerism/pose
aggrandize = μεγαλώνω = magnify/intensify
aggregate = συναθροίζω = gather together/amount to
alacrity = προθυμία = willingness/zeal/fervor
alleviate = καταπραϋνω = assuage/mitigate/soothe
ambiguous = ασαφής = vague/indeterminate/equivocal
amdivalence = αμφιθυμία = haze/uncertainty
anoint = αλείφω = rub/bless
apocryphal = ψεύτικο/πλαστό = counterfeit/spurious/fictitious
arcane = κρυφό / γνωστό σε λίγους = obscure/secret
arduous = επίπονος = toilsome/strenuous
articulate = σαφής = eloquent/fluent/lucid
artless = άτεχνος/απλοϊκός = candid/guileless
ascertain = διαπιστώνω = determine/verify
ascetic = ασκητικός = austere/abstemious
assuage = ανακουφίζω (ασουέιντζ) = alleviate/placate/mitigate/soothe
audacious = παράτολμος/θρασύς/αυθάδης = imputend/presumptuous
augment = επαυξάνω = amplify/heighten
aver = ισχυρίζομαι = declare/allege/avow
balk = εμποδίζω/διστάζω/δειλιάζω = hesitate/dodge/evade/circumvent
base = ποταπός/ευτελής = disgraceful/despicable
belie = διαψεύδω = deny/conceal/refute/confute/gainsay
benign = πράος/καλοήθης (για όγκο) = benevolent/amiable
bogus = κίβδηλος = counterfeit/spurious/phony
bolster = υποστηρίζω / ενισχύω (θεωρία) = reinforce/buttress/strengthen/substantiate
boorish = άξεστος = lout/vulgar
burgeon = επεκτείνομαι = flourish/thrive/sprout
buttress = υποστηρίζω/ενδυναμώνω = strengthen/back up/bulwark
bygone = παλιός / περασμένος = one-time/erstwhile/antiquated
candid = ειλικρινής / ευθύς = straight/direct/impartial
canonical = κανονικός = regular/orderly
capricious = ιδιότροπος = mercurial/volatile/inconsisten
castigate = τιμωρώ/επιπλήτω = chasten/chastise
catalyst = καταλύτης = impetus/incentive
caustic = καυστικός = acrimonious/poignant
censure = μομφή/επίκριση = reproach/decry/rebuke/reprimand
chauvinism = σωβινισμός = nationalism
clamor = κραυγή/βοή/κραυγάζω = outcry/yell
clinch = σταθεροποιώ = squeeze/grapple/embrace
coalesce = ενώνομαι/συνασπίζομαι = confederate/league
cogent = πειστικός/αδιάσειστος = irrefutable/compelling
commensurate = ανάλογος = analogous/proportional
complacent = αυτάρεσκος/αυτός που δεν προσπαθεί περαιτέρω γιατί είναι ικανοποιημένος με κάτι = content/smug
concede = παραδέχομαι = admit/confess/acknowledge
conciliatory = διαλλακτικός/συμφιλιωτικός = resilient/placatory
concur (with an idea)= συμφωνώ/συμπίπτω = collaborate/acquiesce
condone = συγχωρώ/παραβλέπω = overlook/disregard
confer = συνδιασκέπτομαι/χορηγώ = consult/bestow(συνδιασκέπτομαι)/converse(συνδιασκέπτομαι)/grant(χορηγώ)
connoiseur = (για θέματα γεύσης) ειδήμονας/γνώστης = cognoscente/expert
console = παρηγορώ = solace/comfort/assuage
consolidate = σταθεροποιώ/εδραιώνω/ενοποιώ = stabilize/integrate/unify
constrict = σφίγγω/περιορίζω = restrain/confine
construe = ερμηνεύω = interpret/expound
contentious = αμφισβητήσιμος/φιλόνικος = questionable/disputatious/scrappy/argumentative
conundrum = αίνιγμα = riddle/enigma/mystery
converge = συγκλίνω = meet/coincide/mingle/intersect
conversant (to be conservant with) = γνώστης/ενήμερος = acquainted with/versed (with)/connoisseur
convoluted = σπειροειδής/δυσνόητος/μπερδεμένος = tortuous/elaborate(adj)/intricate/involved
copious = άφθονος/πλούσιος/παραγωγικός(για συγγραφέα) = bountiful/abundant/profuse/replete
corroborate = ενισχύω μια άποψη, ιδέα με νέα στοιχεία / επιβεβαιώνω = substantiate/bolster/buttress
countenance = υποστηρίζω/επιδοκιμάζω/εγκρίνω (κάουντενανς) = abet/advocate
counterintuitive = αντιφατικό με τη διαίσθηση = fortuitous
covert = συγκαλυμμένος = concealed
craven = δειλός/άνανδρος = pusillanimous/timorous/diffident/coward
credulous = εύπιστος = gullible/naive
crescendo = βαθμιαία αύξηση της φωνής-μουσικής = pinnacle
culminate = κορυφώνομαι = climax/terminate/come to a head
