daunt = αποθαρρύνω = dishearten, discountenance
debase = υποτιμώ = underestimate, vilify, degrade, demean, derogate
debunk = απομυθοποιώ = demistify, ridicule
decorous = ευπρεπής = decent, seemly
deface = παραμορφώνω = contort, disfigure
default = αθετώ = abrogate, breach
deference = σεβασμός = veneration, courtesy, esteem
deflect = παρεκκλίνω = deviate
deleterious = επιβλαβής = harmful, detrimental, damaging, injurious
delientate = σκιαγραφώ, depict, circumscribe
denigrate = δυσφημώ = disparage, vilify, libel
denote = υποδηλώνω = imply, connote
deride = χλευάζω = taunt, gibe, flout
desiccate = ξηραίνω = blight, evaporate
deterrent = προληπτικός = preventive, superstitious, precautionary
diatribe = λίβελος = tirade, denunciation, reviling, harangue
disgress = εκτρέπομαι = deviate, stray, veer
discrepancy = ασυμφωνία = inconsistency, disparity, variance, divergence, dissonance, incongruity
disingenuous = ανειλικρινής = insidious, deceitful, duplicitous, guileful
dispassionate = απαθής = moderate, serene, temperate, impartial, unbiased
disperse = διασκορπίζω = diessminate, scatter, dispel, dissipate
disposition = διάθεση = temper, spirit, inclination
disquieting = ανησυχητικός = disturbing, irritating, unnerving, vexing, petrubing
disseminate = διαδίδω = spread, propagate, diffuse
dissent = διαφωνία = objection, discord, demur, dissention
dissonance = παραφωνία = discord, cacophony
distill = αποστάζω = ferment, purify 
diverge = αποκλίνω = dissent, divide, disgress
dormant = λανθάνων = inert, latent
divest = αφαιρώ = deprive, strip
dubious = αμφίβολος = ambiguous, equivocal, unfathomable
eclectic = εκλεκτικός = varied, manifold
efficacy = αποτελεσματικός = vigor, potency
egalitarian = υποστηρικτής της ισότητας = equable, equitable, just
egregious = διαβόητος = notorious, flagrant, distinguished
elated = περήφανος = exhilarated, jubilant, excultant, joyous
elevate = εξυψώ = advance, upgrade, exalt
elicit = αποσπώ = extract, educe, derive, deduce
eloquent = εύγλωττος = silver-tongued, articulate
embellish = στολίζω = aborn, bedizen
eminent = εξέχων = oustanding, conspicious, celebrated, renowned
emulate = μιμούμαι = replicate, echo
enervate = εξασθενίζω = enfeeble, debilitate, sap, exhaust
enumerate = απαριθμώ = calculate, compute
equitable = δίκαιος = impartial, even-handed
erratic = ακανόνιστος = abnormal, inconsistent, desultory
erudite = σοφός = scholarly
eschew = αποφεύγω = avoid, circumvent, forgo
estimable = εκτιμήσιμο = valued, esteemed, meritorious
eulogy = εγκώμιο = panegyric, tribute
exacerbate = χειροτερεύω = worsen, aggravate, irritate, enrage
exacting = απαιτητικός = painstking, laborious, toilsome
exculpate = αθωώνω = acquit, vindicate, exonerate
exponent = υποστηρικτής = advocate, partisan, indicator
extraneous = peripheral, superfluous
extrapolate = εικάζω = estimate, conjecture
facetious = ευτράπελος = jocose, jocular, flippant
fallacious = απατηλός = bogus, fraudulent, elusive
fathom = εμβαθύνω = grasp, comprehend
fidelity = ευκρίνεια = loyalty, adherence to truth
finesse = φινέτσα = style, sophistication, technique
flag = χαλαρώνω = ralax, slacken
fleeting = φευγαλέος = transitory, ephemeral
foment = υποδαυλίζω = incite, instigate
foreshadow = προμηνύω = omen, betoken, portend, adumbrate
forfeit = κατάσχω = seize, confiscate
fringe = περιθωριακός = peripheral, marginal 
frugal = οικονόμος = thrifty, provident
futile = μάταιος = pointless, feckless, nugatory
gainsay = αρνούμαι = refute, dispute, naysay, contradict, rebut
garrulous = φλύαρος = chatty, verbose, loquacious
gauche = αδέξιος = slob, slouch
gawky = αδέξιος = clumpsy
germane = σχετικός = relevant, pertinent
gist = ουσία = essence, pitch
glib = ετοιμόλογος = fluent, volumble
gradation = διαβάθμιση = escalation
gragarious = αγελαίος = convival, sociable, affable
guile = δόλος = deceit, beguilement, craft, cunning 
